####################
#                  P
#####  ##  ### #####
#      ##  #  M    #
#      ##  ####### #
#               c  #
### ###### #########
###  c      #    # #
#######  #  M    # #
#     |  # #     # #
############### ## #
#   #       #  M   #
#   #       #      #
# ### #### #### ## #
#    M #     #   #c#
#     #### #### ## #
#           c      #
#     ##############
# L S |    c     X #
####################