####################
#              |   P
#####  ##  ### #####
#      ##  #  M    #
#      ##  ####### #
#               c  #
### ###### #########
###  c      #    # #
#######  #  M    # #
# K      # #     # #
############### ## #
#   #       #  M   #
#   #       #      #
# ### #### #### ## #
#    M #     #   #c#
#     #### #### ## #
#     #      c     #
#     ##############
# L S      c       #
####################